BẢO HIỂM XÃ HỘI VIỆT
  NAM
BẢO
  HIỂM XÃ HỘI
TP. HỒ CHÍ MINH
-------
CỘNG HÒA XÃ HỘI CHỦ
  NGHĨA VIỆT NAM
Độc lập - Tự do - Hạnh phúc
---------
Số: 3268/BHXH-PTHU
V/v sửa
  đổi, bổ sung phương thức thu BHYT đối với NLĐ là người nước ngoài
TP. Hồ Chí Minh, ngày 6
  tháng 11 năm 2009
Kính gửi:
Các đơn vị sử dụng lao
động trên địa bàn TP. Hồ Chí Minh.
Qua ý kiến trao đổi của các đơn vị
sử dụng lao động (Đơn vị) về việc tham gia BHYT đối với người lao động là ngưới
nước ngoài (NLĐNN) theo Luật BHYT, Bảo hiểm xã hội thành phố hướng dẫn sửa đổi,
bổ sung phương thức thu BHYT đối với NLĐNN tại mục 1 công văn số 3104/BHXH-PTHU
như sau;
1. Đơn vị và NLĐNN đóng BHYT hằng
tháng và được cấp thẻ BHYT có thời hạn sử dụng như những người lao động khác
trong đơn vị.
2. Đơn vị lập “Danh sách lao động đề
nghị cấp sổ BHXH, thẻ BHYT” (mẫu số 01a-TBH), và “Danh sách điều chỉnh lao động
và mức lương đóng BHXH, BHYT, BHTN” (mẫu số 03a-TBH) cho NLĐNN theo danh sách
riêng. Phương pháp lập mẫu biểu tương tự như đối với người lao động Việt Nam
tham gia BHYT, BHTN, BHXH. Tại cột ghi chú ghi mã Quốc tịch (danh sách đính
kèm).
Trước khi lập danh sách, đơn vị liên
hệ trực tiếp cán bộ chuyên quản thu – cơ quan Bảo hiểm xã hội để được cấp mã
đơn vị quản lý.
3. Đơn vị lập chứng từ nộp tiền BHYT
riêng cho NLĐNN, ghi rõ mã đơn vị quản lý trên chứng từ nộp tiền.
Đề nghị các đơn vị trên địa bàn
thành phố thực hiện theo hướng dẫn trên. Trong quá trình triển khai thực hiện,
nếu có vướng mắc thì phản ánh kịp thời về Bảo hiểm xã hội thành phố để được xem
xét giải quyết./.
Nơi nhận:
-
  Như trên.
- BGĐ BHXH.TP;
- Các phòng chức năng;
- BHXH quận, huyện;
- Đăng tải trên trang web của BHXH TP;
- Lưu VT, Pthu.
KT. GIÁM ĐỐC
PHÓ
  GIÁM ĐỐC
Đỗ
  Quang Khánh
DANH MỤC MÃ QUỐC TỊCH
A
AD: Andorra
AE: United Arab Emirates
AF: Afghanistan
AG: Antigua and Barbuda
AI: Anguilla
AL: Albania
AM: Armenia
AN: Netherland Antilles
AO: Angola
AQ: Antarctica
AR: Argentina
AS: American Samoa
AT: Austria
AU: Australia
AW: Aruba
AZ: Azerbaidjan
B
BA: Bosnia-Herzegovina
BB: Barbados
BD: Banglades
BE: Belgium
BF: Burkina Faso
BG: Bulgaria
BH: Bahrain
BI: Burundi
BJ: Benin
BM: Bermuda
BN: Brunei Darussalam
BO: Bolivia
BR: Brazil
BS: Bahamas
BT: Buthan
BV: Bouvet Island
BW: Botswana
BY: Belarus
BZ: Belize
C
CA: Canada
CC: Cocos (Keeling) Isl.
CF: Central African Rep.
CG: Congo
CH: Switzerland
CI: Ivory Coast
CK: Cook Islands
CL: Chile
CM: Cameroon
CN: China
CO: Colombia
CR: Costa Rica
CS: Czechoslovakia
CU: Cuba
CV: Cape Verde
CX: Christmas Island
CY: Cyprus
CZ: Czech Republic
D
DE: Germany
DJ: Djibouti
DK: Denmark
DM: Dominica
DO: Dominican Republic
DZ: Algeria
E
EC: Ecuador
EE: Estonia
EG: Egypt
EH: Western Sahara
ES: Spain
ET: Ethiopia
F
FI: Finland
FJ: Fiji
FK: Falkland Isl.(Malvinas)
FM: Micronesia
FO: Faroe Islands
FR: France
FX: France (European Ter.)
G
GA: Gabon
GB: Great Britain (UK)
GD: Grenada
GE: Georgia
GH: Ghana
GI: Gibraltar
GL: Greenland
GP: Guadeloupe (Fr.)
GQ: Equatorial Guinea
GF: Guyana (Fr.)
GM: Gambia
GN: Guinea
GR: Greece
GT: Guatemala
GU: Guam (US)
GW: Guinea Bissau
GY: Guyana
H
HK: Hong Kong
HM: Heard &amp; McDonald Isl.
HN: Honduras
HR: Croatia
HT: Haiti
HU: Hungary
I
ID: Indonesia
IE: Ireland
IL: Israel
IN: India
IO: British Indian O. Terr.
IQ: Iraq
IR: Iran
IS: Iceland
IT: Italy
J
JM: Jamaica
JO: Jordan
JP: Japan
K
KE: Kenya
KG: Kirgistan
KH: Cambodia
KI: Kiribati
KM: Comoros
KN: St.Kitts Nevis Anguilla
KP: Korea (North)
KR: Korea (South)
KW: Kuwait
KY: Cayman Islands
KZ: Kazachstan
L
LA: Laos
LB: Lebanon
LC: Saint Lucia
LI: Liechtenstein
LK: Sri Lanka
LR: Liberia
LS: Lesotho
LT: Lithuania
LU: Luxembourg
LV: Latvia
LY: Libya
M
MA: Morocco
MC: Monaco
MD: Moldavia
MG: Madagascar
MH: Marshall Islands
ML: Mali
MM: Myanmar
MN: Mongolia
MO: Macau
MP: Northern Mariana Isl.
MQ: Martinique (Fr.)
MR: Mauritania
MS: Montserrat
MT: Malta
MU: Mauritius
MV: Maldives
MW: Malawi
MX: Mexico
MY: Malaysia
MZ: Mozambique
N
NA: Namibia
NC: New Caledonia (Fr.)
NE: Niger
NF: Norfolk Island
NG: Nigeria
NI: Nicaragua
NL: Netherlands
NO: Norway
NP: Nepal
NR: Nauru
NT: Neutral Zone
NU: Niue
NZ: New Zealand
O
OM: Oman
P
PA: Panama
PE: Peru
PF: Polynesia (Fr.)
PG: Papua New
PH: Philippines
PK: Pakistan
PL: Poland
PM: St. Pierre &amp; Miquelon
PN: Pitcairn
PT: Portugal
PR: Puerto Rico (US)
PW: Palau
PY: Paraguay
Q
QA: Qatar
R
RE: Reunion (Fr.)
RO: Romania
RU: Russian Federation
RW: Rwanda
S
SA: Saudi Arabia
SB: Solomon Islands
SC: Seychelles
SD: Sudan
SE: Sweden
SG: Singapore
SH: St. Helena
SI: Slovenia
SJ: Svalbard &amp; Jan Mayen Is
SK: Slovak Republic
SL: Sierra Leone
SM: San Marino
SN: Senegal
SO: Somalia
SR: Suriname
ST: St. Tome and Principe
SU: Soviet Union
SV: El Salvador
SY: Syria
SZ: Swaziland
T
TC: Turks &amp; Caicos Islands
TD: Chad
TF: French Southern Terr.
TG: Togo
TH: Thailand
TJ: Tadjikistan
TK: Tokelau
TM: Turkmenistan
TN: Tunisia
TO: Tonga
TP: East Timor
TR: Turkey
TT: Trinidad &amp; Tobago
TV: Tuvalu
TW: Taiwan
TZ: Tanzania
U
UA: Ukraine
UG: Uganda
UK: United Kingdom
UM: US Minor outlying Isl.
US: United States
UY: Uruguay
UZ: Uzbekistan
V
VA: Vatican City State
VC: St.Vincent &amp; Grenadines
VE: Venezuela
VG: Virgin Islands (British)
VI: Virgin Islands (US)
VN: Vietnam
VU: Vanuatu
W
WF: Wallis &amp; Futuna Islands
WS: Samoa
Y
YE: Yemen
YU: Yugoslavia
Z
ZA: South Africa
ZM: Zambia
ZR: Zaire
ZW: Zimbabwe
Tải Văn bản tiếng Việt
Tải Văn bản tiếng Việt